########################################
#XXXXXX_XXVXO_XXXXXOXOXXXXXXXXXXOX__OXX#
#XOSOXXXXXX_XXXXXXXXXOVXXO__XXX_XXXOXXX#
#XXXXXXXXXX_XXX_XXOXOXOXXOXXXXOXXXOXOXX#
#OXX__VXXXX_OOXXXXXXXXXXXXXOOO__OOVXOXX#
#XXXXXOO__XXXXXXXXMXXO__OXXXXXXO_OXOOXX#
########################################
#X_XXXOXXVX_XXOXOXXXXXXXXXXXVXO_XXXXOXX#
#XXVXXXXXOXXXXXOXXXXXXXXXO__OXXVXXXOXXX#
#XXXOXXOXOXXXXXXXXXXXXXXXOOXOXXOXXXXXXX#
#XX_OXXXOXXXXXXOOXXXXXXXXXXOOXXOXVOOXX_#
#XVXXXXXXXOOV__OVXXXOXXXX__OXXXOX_XXOOX#
#XX___OXXXOO_OXXXXXXX_OOXXXXX_OXXXXXXXX#
#OXXXXXXXXOXXXX_OXOXXXXXXVXXXXO_O_XXXXX#
#XOOXOXXXXXX_OXXXXXXXOXXXXOXXXXXX_XXXXX#
#XXXXXXXXX##############################
#__XXOXXXOXXXXXXVXXX__O_OXXXXXXXOXXXXXX#
#XXXXXXOXXXXXOXXOXXXOXXXXXXXXXXXX__X_XX#
#XXOXXX__OXXXXXXXXOXVVOXXXXXOO__XXXXXXE#
#XXX_XXXXOVOOXXXXXOXXXXX_OOXXXXXXOXXXXX#
#XXVXXXXXOXXXOXXXXOXXXXXXX__XXXXXXXXXOX#
########################################